NO ./img/weird.xpm
SO ./img/metal.xpm
WE ./img/rock.xpm
EA ./img/plank.xpm

C 135,206,235
F 34,139,34


        1111111111111111111111111
        1000000000000000000000001
        1011000000000000000000001
        1011000000000000000000001
        1011000000000000000000001
        1011E00000000000000000001
        1011000000000000000000001
        1011000000000000000000001
        1001000000000000000000001
111111111011000001110000000000001
100000000011000001110111111111111
1111011111111101110000001
11111111111111011101010011111
11000000110101011100000010001
10000000000000001100000010001
10000000000000001101010010001
110000011101010111110111100111
11110111 1110101 101111010001
11111111 1111111 111111111111
