NO ./img/east3.xpm
SO ./img/south3.xpm
WE ./img/huaydin.xpm
EA ./img/eelasam.xpm

C 135,206,235
F 34,139,34

1111111111111111111111111111111
1000000000110000000000000000011
10110000011111111110000010001
10010000000000010000000010001
11110000000100010000000000111
10000000000100010000011110011
1111000000010N010000000010001
11110100000100010000010010001
1100000011111111110000001000011111
100000001    111110001100000000001
1000000001111000000101001000111111
11000000000000011111011110001
11110111111101011111011110001
11111111111111111111111111111



