
NO ./img/plank2.xpm


SO    ./img/rock2.xpm

WE ./img/huaydin.xpm

EA                  ./img/eelasam.xpm


C 135,206,235

F       34,               139                                             ,       34







        1111111111111111111111111
        1000000000110000000000001
        1011000001110000000000001
        1001000000000000000000001
111111111011000001110000000000001
100000000011000001110111110111111
11110111111111011100000010001
11110111111111011101010010001
11000000110101011100000010001
100000000000000011000000100010
100000000000000011010100100010
11000001110101011111011110N0111
11110111 1110101 101111010001
11111111 1111111 111111111111
