NO ./img/east3.xpm
SO ./img/south3.xpm
WE ./img/huaydin.xpm
EA ./img/eelasam.xpm

C 135,206,235
F 34,139,34

1111111111111111111111111111111
100000000000001111110000000001
101111111111101111110111110101
10000000000010100000000010001
11110000000100010000000000111
10000000000100010000011110011
111100000001011010000000010001
11110100000100W10000010010001
1100000011111111110000001000011111
100000001    111110001100000000001
1000000001111000000101001000111111
11000000000000011111011110001
11110111111101011111011110001
11111111111111111111111111111



