NO ./images/NO.xpm
SO ./images/SO.xpm
WE ./images/WE.xpm
EA ./images/EA.xpm
F 110,153,15 
F 110,153,15 
C 255,255,255

1111111111111111111111111
1000000011111111110000001
1011111011111111011111101
1000000000000000010000001
1011111011111111011110001
1011111011     1011110001
10000000111    1110000001
111111111111   111110N011
1000000011111  1110000001
1011111011111111011110101
1000000000000000000000001
1111111111111111111111111