NO textures/wall_1.xpm
SO textures/wall_2.xpm
WE textures/wall_3.xpm
EA textures/wall_4.xpm

F 120,100,21
C 25,30,80


111111111111111111111111111111
111111111000100000000000011111
100000000000000000111000100001
110000100000000000000000001111
100001111111000000000000111111
1111111000000000W0000000000001
110000000000000000000000000111
110000000000011110000000000011
100000000000111000000000000011
110000000000111000000000001111
110000000001111000000000000111
111111111111111111111111111111111
